1 2 1 2 1 2 1 2 1
2 3 4 1 5 4 3 1 2
1 5 4 3 2 1 2 5 1
2 1 2 3 4 5 4 2 2
1 2 1 2 1 2 1 2 1
