0 1 1 1 1 1 1 1 0
0 3 0 5 0 5 0 3 0
4 2 2 2 2 2 2 2 4
0 2 4 2 5 3 4 2 0
0 1 1 1 1 1 1 1 0
